R,C,C,M,C,C,R,C,R_s,M
C_b,M,C,C,C,M,C,C,M,C
C,C,C,R,C,C,C,R,C,C
C,M,C,C,C,M,R,C,C,M
M,C,C,M,C,C,R,C,R,C
C,C,C,R,C,C,C,M,C,M
R,C,M,C,C,R,C,C,R,C