R,C,C,M,C,C,R,C,C,M
C_b,M,C,C,C,M,C,C,M,C
C,C,C,R,C,C,C,R,C,C
C,M,C,C,C,M,R,C,C,M
M,C,C,M,C,C,R,C,R,C
C,M,R,C,C,M,C,M,C,C
R,C,C,R,C,C,C,C,C,R
R,C,M,C,C_g,R,C,R,C,M
C,C,C,R,C,C,C,M,C,R
R,R_s,M,C,C,R,C,C,R,C